W,,PW,,,,,,,,,
,,,,,,M,,,,,,,
W,,,,,,,W,W,,W
,,,,,B,,,,,,,,
,W,w,,,,,M,,,,
,,,,,,,,G,,,,,


W,,PW,!,W,W,,W
Iw,,,,I,,,,I,,
W,W,WP,,W,W,,W
I,LI#,,,,IM,,,
,W,w,,W,,WXIW,
,Z,,,I,,G,,,L,