W,,PW,!,W,W,,W
Iw,,,,I,,,,I,,
W,W,W,,,W,W,,W
I,LI#,,,,IM,,,
,W,w,,W,,WXIW,
,Z,,,I,,G,,,L,


W,,PW,!,W,W,,W
Iw,,,,I,,,,I,,
W,W,WP,,W,W,,W
I,LI#,,,,IM,,,
,W,w,,W,,WXIW,
,Z,,,I,,G,,,L,