,,,,,,,,,,,,,U
,,,,,,,,WWW,,U
,,,,,,,,WWW,,,
,,,M,,,,,,,,,#
,,,,,,,,,,,,P#
,,,,,,,,,,,,,Z

W,,,L,L,Z,,#,,
,,,,,W,,,,,,,,
,,,,W,,,,,WWW,
,,,,,P,,IW,,,,
WWW,w,w,,,,,,,
#,,,,,,,!,,,,U


W,,,L,L,L,,L,,
,,,,,W,,,,,,,,
,,,,WMW,,,,,,,
,,,,,P,,,,,,,,
WWW,w,w,,,,,,,
G,,,,,,,B,,,,,


W,,,,,,,,,,,,,
,,,,,,,,,,,,,,
,,,,,L,,,,W,,W
,,,,,P,,,G,,,,
,,,w,,,,,,,,,,
,,,,,,,,,,,,,,



W,,PW,!,W,W,,W
Iw,,,,I,,,,I,,
W,W,WP,,W,W,,W
I,LI#,,,,IM,,,
,W,w,,W,,WXIW,
,Z,,,I,,G,,,L,